#####################
#P                  #
# 1T           2T   #
# ################# #
# #               # #
# # 1A        G   # #
# #               # #
# ################# #
#       R           #
#####################