###################
#P            2S  #
#                 #
#   1S ########## #
#   ## #      3D G#
# 1T   #      ### #
# 1A ############ #
#            3S   #
###################