###################
#P                #
#  1T             #
#  ################
#             2S G#
#              ####
#1A               #
###################