###################
#P        1D 1A 2S#
#         #########
#            1T####
#1A#################
#    ##   2D   ####
#    1S    #     G#
###################