###############
#P            #
#   1T        #
#   ###########
#   1A      G #
#   ###########
#             #
###############