#################
#P          1D G#
#           ### #
#               #
# 1S ########## #
# ## #        # #
#    #   2T   # #
#    #   2A   # #
#    ########## #
#               #
#################