#############################
#P #1S#      #1T#           #
#  # ####### # ########### #
## # #1D#    # #           #
#  # # ### ### # ###########
#  # # # # #2A# #           #
#  # # # # #### # ###########
#  # # # # #2T# #           #
#  # # # # #### # ###########
#  # # # #      #           #
#  ### # ####### # #########
# #1S# #         # #G#     #
#  ### ########### ###     #
#                          #
#############################