#########################
#P                  3S  #
#                   ##  #
# 1T        2D       G  #
# ## ############## ##  #
# 1A #          4D  ##  #
#    # 2S          4S#  #
#    # ##             # #
#    #          3T    # #
#    #          3A    # #
#    ################## #
#                       #
#########################