###############
#P   1S   1S G#
# ### ### #####
#     1D      #
###############
