###########
#P   #   G#
# ### # ###
#     #   #
###########
