###################
#P                #
# ############### #
# #             # #
# # ########### # #
# # #         # # #
# # #    T    # # #
# # #         # # #
# # ########### # #
# #      A      # #
# ############### #
#                 #
#G                #
###################