################
#P   S   D     #
# ####### ######
#   R      G   #
################
