########################
#P   S   D     1T   1A G#
# ### # ### ########### #
#   R #   #  1T    S    #
### ### ### ##########D #
#   A   T   #        ###
# ####### ### ##########
#         #            #
########################
