#############################
#P                          #
# 1T ###################### #
# ## #                2S # #
# 1A # 3T ############# # # #
#    # ## #         4D # # #
#    # 3A # 2T      ## # # #
#    #    # ##         # # #
#    #    # 2A    G    # # #
#    #    ############ # # #
#    #                 # # #
#    ################### # #
#                  4S    # #
#                        # #
########################## #
#         R                #
#############################