#############
#P    #     #
#     #     #
# ### # ### #
# #   #   # #
# # S D # # #
# #   #   # #
# ### # ### #
#     #     #
#     #    G#
#############