###################
#P##            1T#
# ##              #
# ##           ####
# ##    ###       #
# ##  ######1A######
#        ###1D G   #
#       1S#        #
###################