###################
#P                #
# ############### #
# #A#           # #
# ### ########### #
# #T# #         # #
# ### #   ####### #
#     #   #G#     #
#######   ###     #
#                 #
###################