#####################
#P    #         1S  #
#     #         ### #
# 1T  #             #
# ### #         2T G#
#     #         ### #
# 1A  #########     #
#     2A            #
#####################