#########################################
#P    S   #T    # #                     #
#       #D# ### # #######################
#       # # # # #                       #
#       # # ### # #A#####################
#       # #     # # #  #      #  #      #
#       # ##### # # ####      ####      #
#       #     # # # ## #      #G #       #
#       #     # # # ####      #  #      #
#       #         #                     #
#########################################