###################
#P    #S#         #
# ### # # ####### #
# # #   # #     # #
# # # ### # ### # #
# # # #D#   #G# # #
# # # ### ### # # #
# # #         # # #
# # ########### # #
# #             # #
###################