#######################
#P                    #
# ################### #
# #1S               # #
# ################### #
#                     #
# ################### #
# #               2S# #
# ################### #
#         R           #
# ################### #
# #1D      #       2D# #
# ################### #
#                     #
#G                    #
#######################