###################
#P    1T#         #
#     ##     ######
#     1A  1S  2D G#
#     #############
#           1D    #
############      #
#           2S    #
###################