############
#P    T   A#
# ###### ###
#        G #
############
