#################
#P       1A 1S  #
#        ########
# ##        1D G#
#        ########
# ###############
#             1T#
#################