############
#P   S    D#
# # # # ## #
## # # # # #
# # # # ## #
## # # ## T#
# # # # ## #
## # # # # #
# # # # ## #
## # # # # #
# # # # ##A#
## ## ## # #
########## #
#         G#
############