#########################
#P#1T#                  #
# ### ###################
# #   #1A#              #
# #   #### ##############
# #      # #             #
# ###### # # #############
#      # # #             #
# #### # # # #############
# #1T# # # # #G#         #
# # ## # # # ###         #
# #    #   #             #
#########################