###########
#P   S   D#
# ### # ###
#       G #
###########
